XXXXX XXXXXXXXXXXXXXXXXXXXXXXXXXXXXXXXXX
X   X X     XXX  XX        XX   XX     X
X XXX   XXX   X     XX XXX X  X  X XXXXX
X   XXXXXXXXX X XXXXX  X     XXX       X
XXX X       X   XX  XXXXX XX  X  XXX X X
XXX X X XXX XXXXXX  X   X XXXXXXXXXX X X
X X XXX X X X   XXX X X X  X      X  X X
X X     X   X X     X XXXXXX XXXX XXXX X
X   XXX XXX X XXXXXXX    XXX    X      X
X X   X X   X X   X   XX XXXXX XXXXX XXX
X XXX XXXX    X X   X X        X     X X
X     X XXXXX   XXX X   XXXXXXXX XXXXX X
XXXX  X XXXXXXXXXXXXX X X      X X XXX X
X  X  X XXX    XXXX   XXX XXXX XXX X X X
X           XX      X        X     X   X
XXXXXXXXXXXXXXXXXXXXXXXXXXXXXX XXXXXXXXX
________________________________________