XXXXXXXXXXXXXXXXXXX XXXXXXXXXXXXXXXXXXXX
X                 X X                  X
XXXXXXXXXXXXXXXXX X X XXXXXXXXXXXXXXXXXX
X                 X X                  X
X XXXXXXXXXXXXXXXXX XXXXXXXXXXXXXXXXXX X
X                 X X                  X
XXXXXXXXXXXXXXXXX X X XXXXXXXXXXXXXXXXXX
X                 X X                  X
X XXXXXXXXXXXXXXXXX XXXXXXXXXXXXXXXXXX X
X                 X X                  X
XXXXXXXXXXXXXXXXX X X XXXXXXXXXXXXXXXXXX
X                 X X                  X
X XXXXXXXXXXXXXXXXX XXXXXXXXXXXXXXXXXX X
X       X  X   X  X X  X   X   X       X
X XXX X   X  X   XX XX   X   X   X XXX X
XXXXX XXXXXXXXXXXXX XXXXXXXXXXXXXX XXXXX
________________________________________